Pokemon,Max CP,Max HP,Attack,Defense,Stamina,Total Stats,Is Legendary,Type 1,Type 2
Slaking,"4,431",233,290,166,284,740,False,normal,none
Regigigas,"4,346",184,287,210,221,718,True,normal,none
Mewtwo,"4,178",179,300,182,214,696,True,psychic,none
Groudon,"4,115",171,270,228,205,703,True,ground,none
Kyogre,"4,115",171,270,228,205,703,True,water,none
Zekrom,"4,038",171,275,211,205,691,True,dragon,electric
Reshiram,"4,038",171,275,211,205,691,True,dragon,fire
Dialga,"4,038",171,275,211,205,691,True,steel,dragon
Palkia,"3,991",159,280,215,189,684,True,water,dragon
Arceus,"3,989",197,238,238,237,713,True,normal,none
Meloetta,"3,972",187,250,225,225,700,True,normal,psychic
Garchomp,"3,962",198,261,193,239,693,False,dragon,ground
Ho-Oh,"3,863",179,239,244,214,697,True,fire,flying
Rayquaza,"3,835",178,284,170,213,667,True,dragon,flying
Tyranitar,"3,834",187,251,207,225,683,False,rock,dark
Latios,"3,812",160,268,212,190,670,True,dragon,psychic
Dragonite,"3,792",175,263,198,209,670,False,dragon,flying
Metagross,"3,791",160,257,228,190,675,False,steel,psychic
Yveltal,"3,781",204,250,185,246,681,True,dark,flying
Xerneas,"3,781",204,250,185,246,681,True,fairy,none
Heatran,"3,754",175,251,213,209,673,True,fire,steel
Salamence,"3,749",180,277,168,216,661,False,dragon,flying
Darkrai,"3,739",146,285,198,172,655,True,dark,none
Rhyperior,"3,733",207,241,190,251,682,False,ground,rock
Lugia,"3,703",195,193,310,235,738,True,psychic,flying
Keldeo,"3,698",175,260,192,209,661,True,water,fighting
Terrakion,"3,698",175,260,192,209,661,True,rock,fighting
Volcarona,"3,632",166,264,189,198,651,False,bug,fire
Volcanion,"3,628",160,252,216,190,658,True,fire,water
Hydreigon,"3,625",176,256,188,211,655,False,dark,dragon
Haxorus,"3,593",154,284,172,183,639,False,dragon,none
Landorus,"3,588",171,261,182,205,648,True,ground,flying
Kyurem,"3,575",203,246,170,245,661,True,dragon,ice
Zapdos,"3,527",173,253,185,207,645,True,electric,flying
Latias,"3,510",160,228,246,190,664,True,dragon,psychic
Goodra,"3,505",173,220,242,207,669,False,dragon,none
Entei,"3,473",207,235,171,251,657,True,fire,none
Moltres,"3,465",173,251,181,207,639,True,fire,flying
Raikou,"3,452",173,241,195,207,643,True,electric,none
Gyarados,"3,391",180,237,186,216,639,False,water,flying
Giratina,"3,379",233,187,225,284,696,True,ghost,dragon
Hoopa,"3,359",146,261,187,173,621,True,psychic,ghost
Genesect,"3,353",147,252,199,174,625,True,bug,steel
Thundurus,"3,345",158,266,164,188,618,True,electric,flying
Tornadus,"3,345",158,266,164,188,618,True,flying,none
Conkeldurr,"3,337",193,243,158,233,634,False,fighting,none
Togekiss,"3,332",166,225,217,198,640,False,fairy,flying
Archeops,"3,331",153,292,139,181,612,False,rock,flying
Mamoswine,"3,328",200,247,146,242,635,False,ice,ground
Rampardos,"3,298",182,295,109,219,623,False,rock,none
Chandelure,"3,268",132,271,182,155,608,False,ghost,fire
Porygon-Z,"3,266",166,264,150,198,612,False,normal,none
Victini,"3,265",187,210,210,225,645,False,psychic,fire
Shaymin,"3,265",187,210,210,225,645,False,grass,grass
Manaphy,"3,265",187,210,210,225,645,False,water,none
Jirachi,"3,265",187,210,210,225,645,True,steel,psychic
Celebi,"3,265",187,210,210,225,645,True,psychic,grass
Mew,"3,265",187,210,210,225,645,True,psychic,none
Excadrill,"3,244",200,255,129,242,626,False,ground,steel
Florges,"3,234",157,212,244,186,642,False,fairy,none
Gigalith,"3,228",166,226,201,198,625,False,rock,none
Snorlax,"3,225",269,190,169,330,689,False,normal,none
Azelf,"3,210",153,270,151,181,602,True,psychic,none
Magnezone,"3,205",146,238,205,172,615,False,electric,steel
Avalugg,"3,198",180,196,240,216,652,False,ice,none
Rhydon,"3,179",193,222,171,233,626,False,ground,rock
Espeon,"3,170",139,261,175,163,599,False,psychic,none
Deoxys,"3,160",118,345,115,137,597,True,psychic,none
Magmortar,"3,132",153,247,172,181,600,False,fire,none
Tyrantrum,"3,128",162,227,191,193,611,False,rock,dragon
Glaceon,"3,126",139,238,205,163,606,False,ice,none
Regice,"3,122",160,179,309,190,678,True,ice,none
Regirock,"3,122",160,179,309,190,678,True,rock,none
Vaporeon,"3,114",228,205,161,277,643,False,water,none
Darmanitan,"3,105",193,263,114,233,610,False,fire,fire
Heracross,"3,101",160,234,179,190,603,False,bug,fighting
Gallade,"3,093",143,237,195,169,601,False,psychic,fighting
Gardevoir,"3,093",143,237,195,169,601,False,psychic,fairy
Braviary,"3,088",187,232,152,225,609,False,normal,flying
Hippowdon,"3,085",198,201,191,239,631,False,ground,none
Electivire,"3,079",153,249,163,181,593,False,electric,none
Sylveon,"3,069",180,203,205,216,624,False,fairy,none
Delphox,"3,059",153,230,189,181,600,False,fire,psychic
Mesprit,"3,058",160,212,212,190,614,True,psychic,none
Alakazam,"3,057",125,271,167,146,584,False,psychic,none
Machamp,"3,056",173,234,159,207,600,False,fighting,none
Articuno,"3,051",173,192,236,207,635,True,ice,flying
Krookodile,"3,046",180,229,158,216,603,False,ground,dark
Beartic,"3,042",180,233,152,216,601,False,ice,none
Tangrowth,"3,030",187,207,184,225,616,False,grass,none
Flareon,"3,029",139,246,179,163,588,False,fire,none
Arcanine,"3,029",173,227,166,207,600,False,fire,none
Virizion,"3,022",175,192,229,209,630,False,grass,fighting
Cobalion,"3,022",175,192,229,209,630,True,steel,fighting
Exeggutor,"3,014",180,233,149,216,598,False,grass,psychic
Donphan,"3,013",173,214,185,207,606,False,ground,none
Weavile,"3,005",146,243,171,172,586,False,dark,ice
Milotic,"3,005",180,192,219,216,627,False,water,none
Scizor,"3,001",146,236,181,172,589,False,bug,steel
Aggron,"3,000",146,198,257,172,627,False,steel,rock
Suicune,"2,983",187,180,235,225,640,True,water,none
Emboar,"2,982",200,235,127,242,604,True,fire,fighting
Swampert,"2,974",187,208,175,225,608,False,water,ground
Roserade,"2,971",132,243,185,155,583,False,grass,poison
Pinsir,"2,959",139,238,182,163,583,False,bug,none
Chesnaught,"2,954",171,201,204,204,609,False,grass,fighting
Golem,"2,949",160,211,198,190,599,False,rock,ground
Yanmega,"2,946",168,231,156,200,587,False,bug,flying
Ursaring,"2,945",173,236,144,207,587,False,normal,none
Leafeon,"2,944",139,216,219,163,598,False,grass,none
Torterra,"2,934",180,202,188,216,606,False,grass,ground
Reuniclus,"2,927",200,214,148,242,604,False,psychic,none
Pangoro,"2,902",180,226,146,216,588,False,fighting,dark
Empoleon,"2,900",165,210,186,197,593,False,water,steel
Escavalier,"2,889",146,223,187,172,582,False,bug,steel
Typhlosion,"2,889",157,223,173,186,582,False,fire,none
Charizard,"2,889",157,223,173,186,582,False,fire,flying
Luxray,"2,888",160,232,156,190,578,False,electric,none
Jolteon,"2,888",139,232,182,163,577,False,electric,none
Gengar,"2,878",132,261,149,155,565,False,ghost,poison
Cresselia,"2,857",214,152,258,260,670,True,psychic,none
Feraligatr,"2,857",166,205,188,198,591,False,water,none
Golurk,"2,854",171,222,154,205,581,False,ground,ghost
Ampharos,"2,852",173,211,169,207,587,False,electric,none
Armaldo,"2,848",153,222,174,181,577,False,rock,bug
Blaziken,"2,848",160,240,141,190,571,False,fire,fighting
Bisharp,"2,844",139,232,176,163,571,False,dark,steel
Hariyama,"2,829",247,209,114,302,625,False,fighting,none
Kingler,"2,829",125,240,181,146,567,False,water,none
Mr. Mime,"2,827",160,212,179,190,581,False,psychic,fairy
Mr. Mime,"2,228",105,192,205,120,517,False,psychic,fairy
Stoutland,"2,827",166,206,182,198,586,False,normal,none
Samurott,"2,826",180,212,157,216,585,False,water,none
Staraptor,"2,825",166,234,140,198,572,False,normal,flying
Vanilluxe,"2,822",147,218,184,174,576,False,ice,none
Aurorus,"2,802",218,186,163,265,614,False,rock,ice
Gogoat,"2,798",218,196,146,265,607,False,grass,none
Cryogonal,"2,798",160,190,218,190,598,False,ice,none
Bouffalant,"2,797",180,195,182,216,593,False,normal,none
Sawk,"2,788",153,231,153,181,565,False,fighting,none
Omastar,"2,786",146,207,201,172,580,False,rock,water
Aerodactyl,"2,783",160,221,159,190,570,False,rock,flying
Pyroar,"2,767",168,221,149,200,570,False,fire,normal
Noivern,"2,764",166,205,175,198,578,False,flying,dragon
Clawitzer,"2,763",147,221,171,174,566,False,water,none
Sceptile,"2,757",146,223,169,172,564,False,grass,none
Blissey,"2,757",399,129,169,496,794,False,normal,none
Muk,"2,757",193,190,172,233,595,False,poison,poison
Beheeyem,"2,753",153,221,163,181,565,False,psychic,none
Diancie,"2,734",118,190,285,137,612,False,rock,fairy
Unfezant,"2,734",160,226,146,190,562,False,normal,flying
Druddigon,"2,732",155,213,170,184,567,False,dragon,none
Eelektross,"2,732",166,217,152,198,567,False,electric,none
Walrein,"2,726",200,182,176,242,600,False,ice,water
Musharna,"2,723",209,183,166,253,602,False,psychic,none
Venusaur,"2,720",160,198,189,190,577,False,grass,poison
Kabutops,"2,713",132,220,186,155,561,False,rock,water
Honchkrow,"2,711",187,243,103,225,571,False,dark,flying
Porygon2,"2,711",166,198,180,198,576,False,normal,none
Mienshao,"2,710",139,258,127,163,548,False,fighting,none
Scyther,"2,706",146,218,170,172,560,False,bug,flying
Lucario,"2,703",146,236,144,172,552,False,fighting,steel
Gliscor,"2,692",153,185,222,181,588,False,ground,flying
Infernape,"2,683",154,222,151,183,556,False,fire,fighting
Barbaracle,"2,675",149,194,205,176,575,False,rock,water
Flygon,"2,661",160,205,168,190,563,False,ground,dragon
Durant,"2,659",129,217,188,151,556,False,bug,steel
Greninja,"2,654",149,223,152,176,551,False,water,dark
Crobat,"2,646",166,194,178,198,570,False,poison,flying
Kingdra,"2,641",153,194,194,181,569,False,water,dragon
Lapras,"2,641",228,165,174,277,616,False,water,ice
Klinklang,"2,637",132,199,214,155,568,False,steel,none
Houndoom,"2,635",153,224,144,181,549,False,dark,fire
Breloom,"2,628",132,241,144,155,540,False,grass,fighting
Carracosta,"2,621",151,192,197,179,568,False,water,rock
Tauros,"2,620",153,198,183,181,562,False,normal,none
Mismagius,"2,615",132,211,187,155,553,False,ghost,none
Heliolisk,"2,600",135,219,168,158,545,False,electric,normal
Kangaskhan,"2,586",193,181,165,233,579,False,normal,none
Poliwrath,"2,586",173,182,184,207,573,False,water,fighting
Starmie,"2,584",132,210,184,155,549,False,water,psychic
Leavanny,"2,580",153,205,165,181,551,False,bug,grass
Hitmonlee,"2,576",118,224,181,137,542,False,fighting,none
Zoroark,"2,571",132,250,127,155,532,False,dark,none
Nidoking,"2,567",161,204,156,191,551,False,poison,ground
Seismitoad,"2,564",193,188,150,233,571,False,water,ground
Throh,"2,562",214,172,160,260,592,False,fighting,none
Trevenant,"2,559",166,201,154,198,553,False,ghost,grass
Vileplume,"2,559",153,202,167,181,550,False,grass,poison
Jynx,"2,555",139,223,151,163,537,False,ice,psychic
Granbull,"2,552",173,212,131,207,550,False,fairy,none
Sigilyph,"2,550",149,204,167,176,547,False,psychic,flying
Lilligant,"2,550",146,214,155,172,541,False,grass,none
Cloyster,"2,547",118,186,256,137,579,False,water,ice
Slowking,"2,545",180,177,180,216,573,False,water,psychic
Slowbro,"2,545",180,177,180,216,573,False,water,psychic
Crustle,"2,542",146,188,200,172,560,False,bug,rock
Relicanth,"2,528",187,162,203,225,590,False,water,rock
Absol,"2,526",139,246,120,163,529,False,dark,none
Uxie,"2,524",153,156,270,181,607,False,psychic,none
Gorebyss,"2,494",125,211,179,146,536,False,water,none
Toxicroak,"2,488",164,211,133,195,539,False,poison,fighting
Nidoqueen,"2,488",173,180,173,207,560,False,poison,ground
Magneton,"2,485",118,223,169,137,529,False,electric,steel
Crawdaunt,"2,474",136,224,142,160,526,False,water,dark
Lickilicky,"2,467",200,161,181,242,584,False,normal,none
Blastoise,"2,466",158,171,207,188,566,False,water,none
Rapidash,"2,461",139,207,162,163,532,False,fire,none
Drapion,"2,453",146,180,202,172,554,False,poison,dark
Golduck,"2,450",160,191,162,190,543,False,water,none
Politoed,"2,449",173,174,179,207,560,False,water,none
Scolipede,"2,447",132,203,175,155,533,False,bug,poison
Registeel,"2,447",160,143,285,190,618,True,steel,none
Floatzel,"2,443",166,221,114,198,533,False,water,none
Accelgor,"2,441",160,220,120,190,530,False,bug,none
Clefable,"2,437",180,178,162,216,556,False,fairy,none
Victreebel,"2,431",160,207,135,190,532,False,grass,poison
Zebstrika,"2,428",153,211,136,181,528,False,electric,none
Tentacruel,"2,422",160,166,209,190,565,False,water,poison
Gothitelle,"2,419",146,176,205,172,553,False,psychic,none
Ambipom,"2,418",153,205,143,181,529,False,normal,none
Zangoose,"2,418",150,222,124,177,523,False,normal,none
Sawsbuck,"2,416",160,198,146,190,534,False,normal,grass
Steelix,"2,414",153,148,272,181,601,False,steel,ground
Hawlucha,"2,410",157,195,153,186,534,False,fighting,flying
Meganium,"2,410",160,168,202,190,560,False,grass,none
Heatmor,"2,395",166,204,129,198,531,False,fire,none
Magmar,"2,394",139,206,154,163,523,False,fire,none
Gourgeist,"2,390",139,175,213,163,551,False,ghost,grass
Dusknoir,"2,388",111,180,254,128,562,False,ghost,none
Dragalge,"2,383",139,177,207,163,547,False,poison,dragon
Drifblim,"2,382",255,180,102,312,594,False,ghost,flying
Sandslash,"2,374",153,182,175,181,538,False,ground,ice
Grumpig,"2,369",160,171,188,190,549,False,psychic,none
Abomasnow,"2,362",173,178,158,207,543,False,grass,ice
Dodrio,"2,362",132,218,140,155,513,False,normal,flying
Malamar,"2,359",168,177,165,200,542,False,dark,psychic
Skuntank,"2,358",191,184,132,230,546,False,poison,dark
Miltank,"2,354",180,157,193,216,566,False,normal,none
Simipour,"2,350",153,206,133,181,520,False,water,none
Simisear,"2,350",153,206,133,181,520,False,fire,none
Simisage,"2,350",153,206,133,181,520,False,grass,none
Exploud,"2,347",193,179,137,232,548,False,normal,none
Garbodor,"2,345",160,181,164,190,535,False,poison,none
Piloswine,"2,345",187,181,138,225,544,False,ice,ground
Aromatisse,"2,341",188,173,150,226,549,False,fairy,none
Huntail,"2,340",125,197,179,146,522,False,water,none
Manectric,"2,340",146,215,127,172,514,False,electric,none
Jellicent,"2,338",187,159,178,225,562,False,water,ghost
Electabuzz,"2,334",139,198,158,163,519,False,electric,none
Shiftry,"2,333",173,200,121,207,528,False,grass,dark
Hitmonchan,"2,332",118,193,197,137,527,False,fighting,none
Solrock,"2,327",173,178,153,207,538,False,rock,psychic
Lunatone,"2,327",173,178,153,207,538,False,rock,psychic
Gastrodon,"2,324",202,169,143,244,556,False,water,ground
Ludicolo,"2,323",160,173,176,190,539,False,water,grass
Ferrothorn,"2,321",151,158,223,179,560,False,grass,steel
Octillery,"2,315",153,197,141,181,519,False,water,none
Banette,"2,298",138,218,126,162,506,False,ghost,none
Cacturne,"2,298",146,221,115,172,508,False,grass,dark
Weezing,"2,293",139,174,197,163,534,False,poison,none
Primeape,"2,288",139,207,138,163,508,False,fighting,none
Scrafty,"2,283",139,163,222,163,548,False,dark,fighting
Forretress,"2,282",153,161,205,181,547,False,bug,steel
Bellossom,"2,281",153,169,186,181,536,False,grass,none
Wailord,"2,280",283,175,87,347,609,False,water,none
Ninetales,"2,279",150,169,190,177,536,False,fire,ice
Serperior,"2,277",153,161,204,181,546,False,grass,none
Maractus,"2,274",153,201,130,181,512,False,grass,none
Cofagrigus,"2,273",129,163,237,151,551,False,ghost,none
Masquerain,"2,270",146,192,150,172,514,False,bug,flying
Chimecho,"2,259",153,175,170,181,526,False,psychic,none
Cinccino,"2,242",153,198,130,181,509,False,normal,none
Bronzong,"2,239",142,161,213,167,541,False,steel,psychic
Tangela,"2,238",139,183,169,163,515,False,grass,none
Fraxure,"2,234",140,212,123,165,500,False,dragon,none
Cradily,"2,211",168,152,194,200,546,False,rock,grass
Galvantula,"2,206",146,201,128,172,501,False,bug,electric
Talonflame,"2,205",157,176,155,186,517,False,fire,flying
Slurpuff,"2,199",162,168,163,193,524,False,fairy,none
Camerupt,"2,193",146,194,136,172,502,False,fire,ground
Xatu,"2,188",139,192,146,163,501,False,psychic,flying
Raichu,"2,182",132,193,151,155,499,False,electric,electric
Sharpedo,"2,181",146,243,83,172,498,False,water,dark
Alomomola,"2,169",275,138,131,338,607,False,water,none
Gurdurr,"2,169",166,180,134,198,512,False,fighting,none
Stantler,"2,164",150,192,131,177,500,False,normal,none
Stunfisk,"2,162",199,144,171,240,555,False,ground,electric
Seaking,"2,162",160,175,147,190,512,False,water,none
Carnivine,"2,159",151,187,136,179,502,False,grass,none
Hitmontop,"2,156",118,173,207,137,517,False,fighting,none
Sudowoodo,"2,148",146,167,176,172,515,False,rock,none
Sunflora,"2,141",153,185,135,181,501,False,grass,none
Amoonguss,"2,140",206,155,139,249,543,False,grass,poison
Mandibuzz,"2,138",200,129,205,242,576,False,dark,flying
Umbreon,"2,137",180,126,240,216,582,False,dark,none
Pidgeot,"2,129",164,166,154,195,515,False,normal,flying
Pelipper,"2,127",132,175,174,155,504,False,water,flying
Meowstic,"2,124",151,166,167,179,512,False,psychic,none
Furfrou,"2,111",153,164,167,181,512,False,normal,none
Skarmory,"2,108",139,148,226,163,537,False,steel,flying
Mantine,"2,108",139,148,226,163,537,False,water,flying
Phione,"2,105",160,162,162,190,514,False,water,none
Glalie,"2,105",160,162,162,190,514,False,ice,none
Seviper,"2,105",150,196,118,177,491,False,poison,none
Electrode,"2,099",132,173,173,155,501,False,electric,none
Torkoal,"2,093",146,151,203,172,526,False,fire,none
Seadra,"2,093",125,187,156,146,489,False,water,none
Basculin,"2,090",146,189,129,172,490,False,water,none
Hypno,"2,090",166,144,193,198,535,False,psychic,none
Swanna,"2,088",153,182,132,181,495,False,water,flying
Lanturn,"2,085",221,146,137,268,551,False,water,electric
Venomoth,"2,082",146,179,143,172,494,False,bug,poison
Probopass,"2,080",132,135,275,155,565,False,rock,steel
Whiscash,"2,075",200,151,141,242,534,False,water,ground
Spiritomb,"2,072",118,169,199,137,505,False,ghost,dark
Lopunny,"2,059",139,156,194,163,513,False,normal,none
Kadabra,"2,059",105,232,117,120,469,False,psychic,none
Lairon,"2,056",132,158,198,155,511,False,steel,rock
Sneasel,"2,051",125,189,146,146,481,False,dark,ice
Qwilfish,"2,051",139,184,138,163,485,False,water,poison
Cherrim,"2,048",146,170,153,172,495,False,grass,none
Kecleon,"2,047",132,161,189,155,505,False,normal,none
Girafarig,"2,046",146,182,133,172,487,False,normal,psychic
Froslass,"2,040",146,171,150,172,493,False,ice,ghost
Sliggoo,"2,037",143,159,176,169,504,False,dragon,none
Rotom,"2,031",118,185,159,137,481,False,electric,ghost
Shelgon,"2,031",139,172,155,163,490,False,dragon,none
Machoke,"2,031",160,177,125,190,492,False,fighting,none
Boldore,"2,029",146,174,143,172,489,False,rock,none
Noctowl,"2,024",187,145,156,225,526,False,normal,flying
Duosion,"2,018",139,208,103,163,474,False,psychic,none
Whimsicott,"2,014",132,164,176,155,495,False,grass,fairy
Vespiquen,"2,005",146,149,190,172,511,False,bug,flying
Altaria,"2,004",153,141,201,181,523,False,dragon,flying
Fearow,"1,997",139,182,133,163,478,False,normal,flying
Quagsire,"1,992",180,152,143,216,511,False,water,ground
Dewgong,"1,985",173,139,177,207,523,False,water,ice
Swalot,"1,978",187,140,159,225,524,False,poison,none
Golbat,"1,976",153,161,150,181,492,False,poison,flying
Claydol,"1,971",132,140,229,155,524,False,ground,psychic
Ninjask,"1,969",133,199,112,156,467,False,bug,flying
Vigoroth,"1,968",160,159,145,190,494,False,normal,none
Haunter,"1,963",111,223,107,128,458,False,ghost,poison
Purugly,"1,953",147,172,133,174,479,False,normal,none
Klefki,"1,949",128,160,179,149,488,False,steel,fairy
Tropius,"1,941",186,136,163,223,522,False,grass,flying
Mightyena,"1,926",146,171,132,172,475,False,dark,none
Misdreavus,"1,926",132,167,154,155,476,False,ghost,none
Wigglytuff,"1,926",242,156,90,295,541,False,normal,fairy
Pignite,"1,924",173,173,106,207,486,False,fire,fighting
Arbok,"1,921",132,167,153,155,475,False,poison,none
Swellow,"1,920",132,185,124,155,464,False,normal,flying
Graveler,"1,897",125,164,164,146,474,False,rock,ground
Munchlax,"1,892",235,137,117,286,540,False,normal,none
Grotle,"1,890",153,157,143,181,481,False,grass,none
Gabite,"1,874",143,172,125,169,466,False,dragon,ground
Roselia,"1,870",118,186,131,137,454,False,grass,poison
Parasect,"1,859",132,165,146,155,466,False,bug,grass
Gligar,"1,857",139,143,184,163,490,False,ground,flying
Vivillon,"1,855",160,176,103,190,469,False,bug,flying
Klang,"1,847",132,150,174,155,479,False,steel,none
Liepard,"1,846",138,187,106,162,455,False,dark,none
Beedrill,"1,846",139,169,130,163,462,False,bug,poison
Archen,"1,842",125,213,89,146,448,False,rock,flying
Dedenne,"1,841",142,164,134,167,465,False,electric,fairy
Zweilous,"1,839",149,159,135,176,470,False,dark,dragon
Marowak,"1,835",132,144,186,155,485,False,ground,fire
Butterfree,"1,827",132,167,137,155,459,False,bug,flying
Bibarel,"1,823",158,162,119,188,469,False,normal,water
Cranidos,"1,820",142,218,71,167,456,False,rock,none
Watchog,"1,819",132,165,139,155,459,False,normal,none
Mothim,"1,815",146,185,98,172,455,False,bug,flying
Lumineon,"1,814",144,142,170,170,482,False,water,none
Braixen,"1,813",131,171,130,153,454,False,fire,none
Chatot,"1,791",154,183,91,183,457,False,normal,flying
Dragonair,"1,780",133,163,135,156,454,False,dragon,none
Plusle,"1,778",132,167,129,155,451,False,electric,none
Marshtomp,"1,776",146,156,133,172,461,False,water,ground
Wormadam,"1,773",132,141,180,155,476,False,bug,grass
Ariados,"1,772",146,161,124,172,457,False,bug,poison
Illumise,"1,771",139,143,166,163,472,False,bug,none
Volbeat,"1,771",139,143,166,163,472,False,bug,none
Pupitar,"1,766",146,155,133,172,460,False,rock,ground
Beautifly,"1,765",132,189,98,155,442,False,bug,flying
Furret,"1,758",166,148,125,198,471,False,normal,none
Dewott,"1,741",153,159,116,181,456,False,water,none
Raticate,"1,730",125,161,139,146,446,False,normal,dark
Croconaw,"1,722",139,150,142,163,455,False,water,none
Metang,"1,721",132,138,176,155,469,False,steel,psychic
Porygon,"1,720",139,153,136,163,452,False,normal,none
Quilladin,"1,719",133,146,156,156,458,False,grass,none
Swoobat,"1,716",142,161,119,167,447,False,psychic,flying
Eelektrik,"1,715",139,156,130,163,449,False,electric,none
Sealeo,"1,714",173,137,132,207,476,False,ice,water
Lampent,"1,708",132,169,115,155,439,False,ghost,fire
Togetic,"1,708",125,139,181,146,466,False,fairy,flying
Magcargo,"1,702",118,139,191,137,467,False,fire,rock
Prinplup,"1,701",138,150,139,162,451,False,water,none
Ivysaur,"1,699",132,151,143,155,449,False,grass,poison
Ponyta,"1,697",118,170,127,137,434,False,fire,none
Minun,"1,694",132,147,150,155,452,False,electric,none
Dunsparce,"1,689",187,131,128,225,484,False,normal,none
Persian,"1,689",139,150,136,163,449,False,normal,dark
Audino,"1,682",191,114,163,230,507,False,normal,none
Gloom,"1,681",132,153,136,155,444,False,grass,poison
Grovyle,"1,673",118,172,120,137,429,False,grass,none
Linoone,"1,662",157,142,128,186,456,False,normal,none
Kricketune,"1,653",155,160,100,184,444,False,bug,none
Quilava,"1,653",129,158,126,151,435,False,fire,none
Charmeleon,"1,653",129,158,126,151,435,False,fire,none
Combusken,"1,652",132,163,115,155,433,False,fire,fighting
Rhyhorn,"1,651",160,140,127,190,457,False,ground,rock
Frogadier,"1,636",124,168,114,144,426,False,water,none
Jumpluff,"1,636",153,118,183,181,482,False,grass,flying
Tyrunt,"1,635",129,158,123,151,432,False,rock,dragon
Mawile,"1,634",118,155,141,137,433,False,steel,fairy
Emolga,"1,633",125,158,127,146,431,False,electric,flying
Castform,"1,632",146,139,139,172,450,False,normal,none
Weepinbell,"1,611",139,172,92,163,427,False,grass,poison
Gothorita,"1,604",132,137,153,155,445,False,psychic,none
Vanillish,"1,591",120,151,138,139,428,False,ice,none
Dusclops,"1,591",105,124,234,120,478,False,ghost,none
Azumarill,"1,588",187,112,152,225,489,False,water,fairy
Herdier,"1,583",139,145,126,163,434,False,normal,none
Monferno,"1,574",138,158,105,162,425,False,fire,fighting
Murkrow,"1,562",132,175,87,155,417,False,dark,flying
Krabby,"1,561",91,181,124,102,407,False,water,none
Dugtrio,"1,557",98,167,134,111,412,False,ground,ground
Omanyte,"1,544",98,155,153,111,419,False,rock,water
Bastiodon,"1,539",132,94,286,155,535,False,rock,steel
Floette,"1,532",124,136,151,144,431,False,fairy,none
Anorith,"1,529",111,176,100,128,404,False,rock,bug
Flaaffy,"1,521",146,145,109,172,426,False,electric,none
Diggersby,"1,509",166,112,155,198,465,False,normal,ground
Larvesta,"1,496",125,156,107,146,409,False,bug,fire
Delcatty,"1,496",146,132,127,172,431,False,normal,none
Rufflet,"1,491",146,150,97,172,419,False,normal,flying
Pancham,"1,489",142,145,107,167,419,False,fighting,none
Tirtouga,"1,488",124,134,146,144,424,False,water,rock
Wartortle,"1,488",131,126,155,153,434,False,water,none
Luxio,"1,486",132,159,95,155,409,False,electric,none
Sableye,"1,476",118,141,136,137,414,False,dark,ghost
Yanma,"1,470",139,154,94,163,411,False,bug,flying
Fletchinder,"1,469",135,145,110,158,413,False,fire,flying
Wailmer,"1,468",228,136,68,277,481,False,water,none
Carbink,"1,467",118,95,285,137,517,False,rock,fairy
Bayleef,"1,454",132,122,155,155,432,False,grass,none
Darumaka,"1,442",146,153,86,172,411,False,fire,none
Tranquill,"1,442",135,144,107,158,409,False,normal,flying
Servine,"1,441",132,122,152,155,429,False,grass,none
Pawniard,"1,433",111,154,114,128,396,False,dark,steel
Medicham,"1,431",132,121,152,155,428,False,fighting,psychic
Litleo,"1,425",135,139,112,158,409,False,fire,normal
Poliwhirl,"1,419",139,130,123,163,416,False,water,none
Krokorok,"1,418",132,155,90,155,400,False,ground,dark
Lickitung,"1,411",173,108,137,207,452,False,normal,none
Nidorino,"1,393",133,137,111,156,404,False,poison,none
Palpitoad,"1,392",153,128,109,181,418,False,water,ground
Mienfoo,"1,389",111,160,98,128,386,False,fighting,none
Elgyem,"1,385",125,148,100,146,394,False,psychic,none
Corsola,"1,378",125,118,156,146,420,False,water,rock
Drilbur,"1,376",132,154,85,155,394,False,ground,none
Grimer,"1,374",160,135,90,190,415,False,poison,poison
Scraggy,"1,372",118,132,132,137,401,False,dark,fighting
Swadloon,"1,370",125,115,162,146,423,False,bug,grass
Kabuto,"1,370",91,148,140,102,390,False,rock,water
Axew,"1,368",113,154,101,130,385,False,dragon,none
Solosis,"1,367",111,170,83,128,381,False,psychic,none
Amaura,"1,363",155,124,109,184,417,False,rock,ice
Magnemite,"1,362",84,165,121,93,379,False,electric,steel
Hippopotas,"1,358",143,124,118,169,411,False,ground,none
Aipom,"1,348",125,136,112,146,394,False,normal,none
Ledian,"1,346",125,107,179,146,432,False,bug,flying
Abra,"1,342",84,195,82,93,370,False,psychic,none
Spoink,"1,334",132,125,122,155,402,False,psychic,none
Teddiursa,"1,328",132,142,93,155,390,False,normal,none
Loudred,"1,327",165,134,81,197,412,False,normal,none
Magby,"1,323",111,151,99,128,378,False,fire,none
Timburr,"1,315",153,134,87,181,402,False,fighting,none
Nidorina,"1,309",146,117,120,172,409,False,poison,none
Aron,"1,307",118,121,141,137,399,False,steel,rock
Bonsly,"1,302",118,124,133,137,394,False,rock,none
Staravia,"1,299",125,142,94,146,382,False,normal,flying
Geodude,"1,293",105,132,132,120,384,False,rock,ground
Lileep,"1,291",140,105,150,165,420,False,rock,grass
Smoochum,"1,291",111,153,91,128,372,False,ice,psychic
Machop,"1,278",146,137,82,172,391,False,fighting,none
Trapinch,"1,274",111,162,78,128,368,False,ground,none
Vullaby,"1,271",146,105,139,172,416,False,dark,flying
Clamperl,"1,270",98,133,135,111,379,False,water,none
Sandshrew,"1,261",118,126,120,137,383,False,ground,ice
Espurr,"1,259",135,120,114,158,392,False,psychic,none
Buneary,"1,258",125,130,105,146,381,False,normal,none
Frillish,"1,257",125,115,134,146,395,False,water,ghost
Chansey,"1,255",392,60,128,487,675,False,normal,none
Spritzee,"1,252",157,110,113,186,409,False,fairy,none
Skiddo,"1,250",140,123,102,165,390,False,grass,none
Mantyke,"1,248",111,105,179,128,412,False,water,flying
Growlithe,"1,243",125,136,93,146,375,False,fire,none
Cacnea,"1,242",118,156,74,137,367,False,grass,none
Snubbull,"1,237",132,137,85,155,377,False,fairy,none
Farfetch'd,"1,236",121,124,115,141,380,False,normal,flying
Houndour,"1,234",111,152,83,128,363,False,dark,fire
Corphish,"1,230",109,141,99,125,365,False,water,none
Gastly,"1,229",91,186,67,102,355,False,ghost,poison
Oddish,"1,228",111,131,112,128,371,False,grass,poison
Nuzleaf,"1,227",146,134,78,172,384,False,grass,dark
Slowpoke,"1,226",173,109,98,207,414,False,water,psychic
Vibrava,"1,225",118,134,99,137,370,False,ground,dragon
Dwebble,"1,224",118,118,128,137,383,False,bug,rock
Dustox,"1,224",132,98,162,155,415,False,bug,poison
Pumpkaboo,"1,222",117,121,123,135,379,False,ghost,grass
Spinda,"1,220",132,116,116,155,387,False,normal,none
Bergmite,"1,215",125,117,120,146,383,False,ice,none
Koffing,"1,214",105,119,141,120,380,False,poison,none
Pachirisu,"1,213",132,94,172,155,421,False,electric,none
Elekid,"1,206",111,135,101,128,364,False,electric,none
Phanpy,"1,206",173,107,98,207,412,False,ground,none
Roggenrola,"1,205",125,121,110,146,377,False,rock,none
Doduo,"1,200",98,158,83,111,352,False,normal,flying
Drifloon,"1,197",173,117,80,207,404,False,ghost,flying
Lombre,"1,197",132,112,119,155,386,False,water,grass
Pidgeotto,"1,194",136,117,105,160,382,False,normal,flying
Golett,"1,189",131,127,92,153,372,False,ground,ghost
Turtwig,"1,187",125,119,110,146,375,False,grass,none
Unown,"1,185",116,136,91,134,361,False,psychic,none
Karrablast,"1,182",118,137,87,137,361,False,bug,none
Swirlix,"1,179",135,109,119,158,386,False,fairy,none
Zorua,"1,175",105,153,78,120,351,False,dark,none
Exeggcute,"1,175",132,107,125,155,387,False,grass,psychic
Mankey,"1,164",105,148,82,120,350,False,fighting,none
Snover,"1,159",132,115,105,155,375,False,grass,ice
Staryu,"1,157",91,137,112,102,351,False,water,none
Bagon,"1,156",111,134,93,128,355,False,dragon,none
Clefairy,"1,155",146,107,108,172,387,False,fairy,none
Goldeen,"1,152",111,123,110,128,361,False,water,none
Stunky,"1,151",136,121,90,160,371,False,poison,dark
Munna,"1,145",154,111,92,183,386,False,psychic,none
Whirlipede,"1,144",105,100,173,120,393,False,bug,poison
Shellos,"1,136",154,103,105,183,391,False,water,none
Deerling,"1,135",132,115,100,155,370,False,normal,grass
Totodile,"1,131",118,117,109,137,363,False,water,none
Mudkip,"1,128",118,126,93,137,356,False,water,none
Phantump,"1,123",109,125,103,125,353,False,ghost,grass
Chinchou,"1,119",153,106,97,181,384,False,water,electric
Bulbasaur,"1,115",111,118,111,128,357,False,grass,poison
Gible,"1,112",129,124,84,151,359,False,dragon,ground
Pineco,"1,108",118,108,122,137,367,False,bug,none
Psyduck,"1,106",118,122,95,137,354,False,water,none
Natu,"1,102",105,134,89,120,343,False,psychic,flying
Onix,"1,101",98,85,232,111,428,False,rock,ground
Chespin,"1,096",127,110,106,148,364,False,grass,none
Mime Jr.,"1,095",78,125,142,85,352,False,psychic,fairy
Delibird,"1,094",111,128,90,128,346,False,ice,flying
Torchic,"1,093",111,130,87,128,345,False,fire,none
Clauncher,"1,088",118,108,117,137,362,False,water,none
Tepig,"1,083",139,115,85,163,363,False,fire,none
Shellder,"1,080",91,116,134,102,352,False,water,none
Piplup,"1,075",122,112,102,142,356,False,water,none
Eevee,"1,071",125,104,114,146,364,False,normal,none
Cubchoo,"1,069",125,128,74,146,348,False,ice,none
Skrelp,"1,063",118,109,109,137,355,False,poison,water
Flabébé,"1,063",111,108,120,127,355,False,fairy,none
Deino,"1,062",121,116,93,141,350,False,dark,dragon
Numel,"1,057",132,119,79,155,353,False,fire,ground
Horsea,"1,056",91,129,103,102,334,False,water,none
Buizel,"1,054",125,132,67,146,345,False,water,none
Treecko,"1,053",105,124,94,120,338,False,grass,none
Oshawott,"1,046",125,117,85,146,348,False,water,none
Larvitar,"1,040",118,115,93,137,345,False,rock,ground
Drowzee,"1,040",132,89,136,155,380,False,psychic,none
Tentacool,"1,040",105,97,149,120,366,False,water,poison
Sandile,"1,037",118,132,69,137,338,False,ground,dark
Vanillite,"1,033",100,118,106,113,337,False,ice,none
Bellsprout,"1,033",118,139,61,137,337,False,grass,poison
Petilil,"1,030",111,119,91,128,338,False,grass,none
Fennekin,"1,028",105,116,102,120,338,False,fire,none
Wobbuffet,"1,026",310,60,106,382,548,False,psychic,none
Joltik,"1,023",118,110,98,137,345,False,bug,electric
Carvanha,"1,020",111,171,39,128,338,False,water,dark
Cubone,"1,019",118,90,144,137,371,False,ground,none
Shuppet,"1,018",111,138,65,127,330,False,ghost,none
Paras,"1,018",98,121,99,111,331,False,bug,grass
Woobat,"1,016",139,107,85,163,355,False,psychic,flying
Voltorb,"1,010",105,109,111,120,340,False,electric,none
Skorupi,"1,009",105,93,151,120,364,False,poison,bug
Litwick,"1,006",118,108,98,137,343,False,ghost,fire
Chingling,"1,005",111,114,94,128,336,False,psychic,none
Dratini,"1,004",106,119,91,121,331,False,dragon,none
Venonat,"1,004",132,100,100,155,355,False,bug,poison
Slakoth,"1,002",132,104,92,155,351,False,normal,none
Trubbish,"1,000",118,96,122,137,355,False,poison,none
Riolu,993,105,127,78,120,325,False,fighting,none
Nosepass,993,91,82,215,102,399,False,rock,none
Froakie,992,106,122,84,121,327,False,water,none
Mareep,991,125,114,79,146,339,False,electric,none
Yamask,982,102,95,141,116,352,False,ghost,none
Cyndaquil,980,103,116,93,118,327,False,fire,none
Charmander,980,103,116,93,118,327,False,fire,none
Foongus,979,144,97,91,170,358,False,grass,poison
Sewaddle,977,111,96,124,128,348,False,bug,grass
Goomy,976,111,101,112,128,341,False,dragon,none
Beldum,976,105,96,132,120,348,False,steel,psychic
Skiploom,976,125,91,120,146,357,False,grass,flying
Finneon,971,117,96,116,135,347,False,water,none
Seel,971,139,85,121,163,369,False,water,none
Kirlia,966,102,117,90,116,323,False,psychic,fairy
Electrike,965,105,123,78,120,321,False,electric,none
Spheal,962,146,95,90,172,357,False,ice,water
Chimchar,957,111,113,86,127,326,False,fire,none
Klink,956,105,98,121,120,339,False,steel,none
Panpour,956,118,104,94,137,335,False,water,none
Pansear,956,118,104,94,137,335,False,fire,none
Pansage,956,118,104,94,137,335,False,grass,none
Croagunk,952,116,116,76,134,326,False,poison,fighting
Gothita,951,111,98,112,128,338,False,psychic,none
Cherubi,950,111,108,92,128,328,False,grass,none
Binacle,946,107,96,120,123,339,False,rock,water
Squirtle,946,111,94,121,127,342,False,water,none
Ferroseed,941,111,82,155,127,364,False,grass,steel
Pikachu,938,98,112,96,111,319,False,electric,none
Chikorita,935,111,92,122,128,342,False,grass,none
Glameow,934,117,109,82,135,326,False,normal,none
Helioptile,933,111,115,78,127,320,False,electric,normal
Inkay,927,122,98,95,142,335,False,dark,psychic
Ekans,927,98,110,97,111,318,False,poison,none
Lillipup,915,111,107,86,128,321,False,normal,none
Remoraid,912,98,127,69,111,307,False,water,none
Slugma,895,105,118,71,120,309,False,fire,none
Shieldon,890,91,76,195,102,373,False,rock,steel
Snorunt,888,118,95,95,137,327,False,ice,none
Vulpix,883,102,96,109,116,321,False,fire,ice
Blitzle,882,111,118,64,128,310,False,electric,none
Shinx,876,111,117,64,128,309,False,electric,none
Minccino,872,125,98,80,146,324,False,normal,none
Gulpin,866,146,80,99,172,351,False,poison,none
Nidoran♂,860,113,105,76,130,311,False,poison,none
Ducklett,856,135,84,96,158,338,False,water,flying
Budew,856,105,91,109,120,320,False,grass,poison
Snivy,849,111,88,107,128,323,False,grass,none
Pidove,848,118,98,80,137,315,False,normal,flying
Luvdisc,848,109,81,128,125,334,False,water,none
Tympole,839,118,98,78,137,313,False,water,none
Shelmet,834,118,72,140,137,349,False,bug,none
Ditto,832,116,91,91,134,316,False,normal,none
Poliwag,829,105,101,82,120,303,False,water,none
Swablu,824,111,76,132,128,336,False,normal,flying
Barboach,819,118,93,82,137,312,False,water,ground
Makuhita,817,149,99,54,176,329,False,fighting,none
Spinarak,816,105,105,73,120,298,False,bug,poison
Nidoran♀,816,125,86,89,146,321,False,poison,none
Tynamo,811,98,105,78,111,294,False,electric,none
Shroomish,810,132,74,110,155,339,False,grass,none
Fletchling,800,111,95,80,128,303,False,normal,flying
Spearow,798,105,112,60,120,292,False,normal,flying
Patrat,791,111,98,73,128,299,False,normal,none
Surskit,791,105,93,87,120,300,False,bug,water
Baltoy,787,105,77,124,120,321,False,ground,psychic
Purrloin,772,106,98,73,121,292,False,dark,none
Nincada,768,93,80,126,104,310,False,bug,ground
Wingull,765,105,106,61,120,287,False,water,flying
Taillow,765,105,106,61,120,287,False,normal,flying
Meowth,748,105,92,78,120,290,False,normal,dark
Swinub,741,118,90,69,137,296,False,ice,ground
Skitty,739,118,84,79,137,300,False,normal,none
Rattata,734,91,103,70,102,275,False,normal,dark
Ledyba,728,105,72,118,120,310,False,bug,flying
Jigglypuff,724,207,80,41,251,372,False,normal,fairy
Bidoof,721,131,80,73,153,306,False,normal,none
Starly,719,105,101,58,120,279,False,normal,flying
Venipede,706,91,83,99,102,284,False,bug,poison
Duskull,706,78,70,162,85,317,False,ghost,none
Cottonee,700,105,71,111,120,302,False,grass,fairy
Meditite,693,91,78,107,102,287,False,fighting,psychic
Pidgey,680,105,85,73,120,278,False,normal,flying
Poochyena,678,98,96,61,111,268,False,dark,none
Hoothoot,677,132,67,88,155,310,False,normal,flying
Diglett,676,64,109,78,67,254,False,ground,ground
Whismur,671,138,92,42,162,296,False,normal,none
Cleffa,671,118,75,79,137,291,False,fairy,none
Noibat,667,105,83,73,120,276,False,flying,dragon
Zubat,667,105,83,73,120,276,False,poison,flying
Togepi,657,98,67,116,111,294,False,fairy,none
Wooper,641,125,75,66,146,287,False,water,ground
Sentret,618,98,79,73,111,263,False,normal,none
Bronzor,603,128,43,154,149,346,False,steel,psychic
Hoppip,600,98,67,94,111,272,False,grass,flying
Seedot,598,105,71,77,120,268,False,grass,none
Lotad,598,105,71,77,120,268,False,water,grass
Wurmple,578,111,75,59,128,262,False,bug,none
Bunnelby,553,102,68,72,116,256,False,normal,none
Cascoon,553,118,60,77,137,274,False,bug,none
Silcoon,553,118,60,77,137,274,False,bug,none
Ralts,539,89,79,59,99,237,False,psychic,fairy
Igglybuff,535,173,69,32,207,308,False,normal,fairy
Wynaut,534,180,41,86,216,343,False,psychic,none
Zigzagoon,508,102,58,80,116,254,False,normal,none
Combee,494,91,59,83,102,244,False,bug,flying
Scatterbug,492,102,63,63,116,242,False,bug,none
Tyrogue,492,98,64,64,111,239,False,fighting,none
Burmy,488,105,53,83,120,256,False,bug,none
Spewpa,479,111,48,89,128,265,False,bug,none
Pichu,473,78,77,53,85,215,False,electric,none
Marill,461,146,37,93,172,302,False,water,fairy
Weedle,456,105,63,50,120,233,False,bug,poison
Metapod,450,118,45,80,137,262,False,bug,none
Caterpie,437,111,55,55,128,238,False,bug,none
Kakuna,432,111,46,75,128,249,False,bug,poison
Smeargle,431,125,40,83,146,269,False,normal,none
Shuckle,405,78,17,396,85,498,False,bug,rock
Kricketot,401,100,45,74,114,233,False,bug,none
Sunkern,395,91,55,55,102,212,False,grass,none
Shedinja,393,12,153,73,1,227,False,bug,ghost
Happiny,371,187,25,77,225,327,False,normal,none
Azurill,364,118,36,71,137,244,False,normal,fairy
Feebas,274,78,29,85,85,199,False,water,none
Magikarp,274,78,29,85,85,199,False,water,none
Zygarde,14,11,0,0,0,0,False,dragon,ground
Aegislash,14,11,0,0,0,0,False,steel,ghost
Doublade,14,11,0,0,0,0,False,steel,ghost
Honedge,14,11,0,0,0,0,False,steel,ghost
